++++++++++++++++
+    ++++++    +
+ ++         +++
+++           ++
+              +
+              +
+              +
+     ++++     +
+     +  +++   +
+          ++  +
+           ++ +
+        +   + +
+    +++++     +
+              +
+         +++  +
++++++++++++++++
